page|4
||第一节  释义
一、  释义||
在本报告书中，除非文义另有所指，下列词语具有如下含义：||
常用词语释义||
公司、合富中国|指|合富（中国）医疗科技股份有限公司
合富有限|指|合富（中国）医疗科技贸易有限公司，公司的前身
合富上海|指|合富医疗科技贸易（上海）有限公司，系合富有限的前身
合富生化|指|合富生化科技贸易（上海）有限公司，系合富上海的前身
合富台湾|指|合富生化科技股份有限公司
合玺医疗|指|合玺医疗科技贸易（上海）有限公司
合康生物|指|合康生物技术开发（上海）有限公司
合玺香港|指|合玺（香港）控股有限公司
台湾分公司|指|香港商合玺医疗器材有限公司，合玺香港于台湾设立的分公司
合煜医疗|指|天津合富合煜医疗科技有限公司
合富控股|指|Cowealth  Medical  Holding  Co.,  Ltd.（合富医疗控股股份有
||限公司）
合富香港|指|合富（香港）控股有限公司
确资有限|指|确资有限公司（EXCEL WEALTH COPORATION LIMITED）
员程合伙|指|员程（上海）企业管理咨询中心（有限合伙）
员昂合伙|指|员昂（上海）企业管理咨询中心（有限合伙）
员意合伙|指|员意（上海）企业管理咨询中心（有限合伙）
员裕合伙|指|上海员裕企业管理咨询中心（有限合伙）
康君咨询|指|康君咨询管理（上海）有限公司
康永管理|指|康永企业管理（上海）有限公司
华金有限|指|华金发展有限公司（GOLDEN CHINA DEVELOPMENT LIMITED）
荆州慧康|指|荆州慧康股权投资基金合伙企业（有限合伙）
嘉兴海通|指|嘉兴海通旭初股权投资基金合伙企业（有限合伙）
华润投资|指|华润医药（汕头）产业投资基金合伙企业（有限合伙）
祺睿投资|指|宁波梅山保税港区祺睿股权投资中心（有限合伙）
兴原国际|指|上海兴原国际贸易有限公司
联方有限|指|联方有限公司（ALLIED FOCUS CORPORATION LIMITED）
国泰创业|指|国泰创业投资股份有限公司
上海擎天|指|上海擎天企业管理咨询有限公司
合富投资|指|合富投资股份有限公司
文维投资|指|文维投资股份有限公司
杰立投资|指|杰立投资股份有限公司
马克投资|指|马克投资股份有限公司
乐利投资|指|乐利投资股份有限公司
瑞普雷|指|Replay Fortune International Ltd.
高布理克|指|Goldbrick Prime Corp.
Richtek|指|Richtek Technology Limited，为控股股东控制的其他企业
Viewray|指|Viewray  Technology,Inc，美股上市公司的子公司（股票代
||码：VRAY.O）
TearScience|指|TearScience Inc，眼科产品原厂
Accuray|指|Accuray Inc，美股上市公司股票代码 ARAY.O）
佑安医院|指|首都医科大学附属北京佑安医院
柜买中心|指|中国台湾地区财团法人证券柜台买卖中心
page|5
|第二节  公司简介和主要财务指标
一、  公司信息|
公司的中文名称|合富（中国）医疗科技股份有限公司
公司的中文简称|合富中国
公司的外文名称|Cowealth Medical China Co.,Ltd.
公司的外文名称缩写|CMC
公司的法定代表人|王琼芝
二、  联系人和联系方式|
|董事会秘书 证券事务代表
姓名 陈烨|-
联系地址|上海市徐汇区虹漕路456号光启大楼 -
电话 021-60378999|-
传真 021-60378951|-
电子信箱 ir_cowealth@cowealth.com|-
三、 基本情况简介|
公司注册地址|中国（上海）自由贸易试验区新灵路118号606B室
公司办公地址|上海市徐汇区虹漕路456号光启大楼
公司办公地址的邮政编码|200233
公司网址|www.cowealth.com
电子信箱|ir_cowealth@cowealth.com
四、 信息披露及备置地点|
公司披露年度报告的媒体名称及网址|中国证券报（网址www.cs.com.cn）、上海证券报
|（网址www.cnstock.com）、证券时报（网址
|www.stcn.com）、证券日报（网址www.zqrb.cn）
公司披露年度报告的证券交易所网址|www.sse.com.cn
公司年度报告备置地点|董事会办公室
